Xu, Xu, Xu, Xu, Xu, Xu, Xu, Xu, Xu, Xu, Xu, Xu, Xu, Xu, Xu, Xu, Uu^Ii, Uu^Ii, Uu^Ii, Urb, Ur^Br|, Uu^Ii, Uu^Ii, Uu^Ii, Uu^Ii, Xu, Xu, Xu, Xu, Xu, Xu, Xu, Xu, Xu, Xu, Xu
Xu, Xu, Xu, Xu, Xu, Xu, Xu, Xu, Xu, Xu, Xu, Xu, Xu, Xu, Xu, Xu, Uu^Ii, Uu^Ii, Uu^Ii, Urb, Ur^Br|, Uu^Ii, Uu^Ii, Uu^Ii, Uu^Ii, Xu, Xu, Xu, Xu, Xu, Xu, Xu, Xu, Xu, Xu, Xu
Xu, Xu, Xu, Xu, Xu, Xu, Xu, Xu, Xu, Xu, Xu, Xu, Xu, Xu, Xu, Xu, Uu^Ii, Uu^Ii, Uu^Ii, Urb, Ur^Br|, Uu^Ii, Uu^Ii, Uu^Ii, Uu^Tfi, Xu, Xu, Xu, Xu, Xu, Xu, Xu, Xu, Xu, Xu, Xu
Xu, Xu, Xu, Xu, Xu, Xu, Uh, Uh, Uh, Xu, Xu, Xu, Xu, Xu, Uu^Tfi, Uu^Tfi, Ce, Uu^Ii, Uu, Urb, Ur^Br|, Uu^Ii, Uu, Uu^Ii, Uu, Uh^Ii, Xu, Xu, Xu, Xu, Xu, Xu, Xu, Xu, Xu, Xu
Xu, Xu, Xu, Xu, Xu, Uu^Emf, Uu^Emf, Uu, Uu, Uh, Uu^Vu, Uh, Uu, Uu, Ur, Ce, 2 Ke, Ce, Uu, Urb, Ur^Br|, Uu^Br\, Uu^Br\, Uu, Uu, Uh, Uh, Xu, Uh, Xu, Xu, Xu, Xu, Xu, Xu, Xu
Xu, Xu, Xu, Xu, Uh, Uu^Emf, Uu, Uu, Ur, Uu, Uu, Uu, Ur, Ur, Uu, Ce, Ce, Ce, Ur, Urb, Ur^Br|, Uu, Uu, Uu^Br\, Uu^Br\, Uu, Uu, Uh, Uu, Uu^Vu, Xu, Xu, Xu, Xu, Xu, Xu
Xu, Xu, Xu, Xu, Uh, Uh, Uu, Ur, Uu, Uu, Uu^Emf, Uu, Uu, Uu, Uu, Ce, Ce, Ce, Uu, Urb, Ur^Br|, Uu, Uu, Uu, Uu, Uu^Br\, Uu^Br\, Uu, Uu^Br\, Uu, Uu, Xu, Xu, Xu, Xu, Xu
Xu, Xu, Xu, Xu, Xu, Uu, Uu, Uu^Vu, Xu, Uu, Uu, Uu, Uu^Vu, Uu, Xu, Xu, Xu, Uu, Uu, Urb, Ur^Br|, Uu, Xu, Xu, Xu, Uu, Uu, Uu^Br/, Uu, Uu^Br\, Uu^Br\, Uu, Uu, Xu, Xu, Xu
Xu, Xu, Xu, Xu, Xu, Ur, Ur, Xu, Xu, Xu, Uu, Uu, Xu, Xu, Xu, Xu, Xu, Uu, Uu, Urb, Ur^Br|, Uu, Xu, Xu, Xu, Xu, Xu, Uu^Vu, Uu, Uu, Uu^Br/, Uu^Br\, Uu^Br\, Uu, Uu, Uu
Xu, Xu, Xu, Xu, Uu^Tfi, Uu, Ur, Xu, Xu, Xu, Uu^Ii, Uu, Xu, Xu, Xu, Xu, Uh^Ii, Uu, Uu, Urb, Ur^Br\, Uu, Uh, Xu, Xu, Xu, Xu, Uu, Uu^Br|, Uu^Br/, Uh, Uu, Xu, Uu^Br\, Uu^Br\, Uu
Xu, Xu, Xu, Xu, Uu, Uu, Uh, Uu, Uu^Tf, Uu^Tfi, Uu^Ii, Uu^Ii, Xu, Xu, Xu, Uh^Ii, Uu, Uu, Uu, Urb, Urb, Ur^Br\, Ur^Br\, Uh, Xu, Xu, Xu, Uu, Uu^Br|, Uu, Uh, Xu, Xu, Xu, Uu, Uu^Br\
Xu, Xu, Xu, Xu, Uu, Ur, Uh, Uu, Uu, Uu, Uu, Uu, Xu, Xu, Xu, Uh, Uu, Uu, Xu, Xu, Xu, Urb, Urb, Ur^Br|, Xu, Xu, Xu, Uu, Uu^Br|, Uu^Vu, Xu, Xu, Xu, Xu, Uu, Uu
Xu, Xu, Xu, Xu, Uh, Ur, Uu, Uu, Xu, Xu, Xu, Uu, Uu^Tf, Xu, Uu^Tf, Uu, Uu, Uu^Vu, Xu, Xu, Xu, Uu, Urb, Ur^Br|, Uh^Ii, Xu, Uh, Uu, Uu^Br|, Xu, Xu, Xu, Uu, Uu, Uu, Uu
Xom, Xu, Xu, Xu, Uh, Uu, Ur, Uh, Xu, Xu, Xu, Uu, Uu, Uu^Tf, Uu, Uu, Xu, Xu, Xu, Xu, Xu, Uu^Tfi, Urb, Ur^Br\, Ur^Br|, Uh^Ii, Uu, Uu, Uu^Br|, Xu, Xu, Xu, Uu, Uu, Uu, Uu
Uu, Xom, Xom, Xu, Uu^Vu, Uu, Ur, Uh^Ii, Uh^Ii, Xu, Xu, Xu, Xu, Uu, Uu, Uu, Xu, Xu, Xu, Xu, Xu, Uu^Tfi, Uu^Tfi, Urb, Ur^Br|, Uu, Uu, Uu, Uu^Br/, Uu^Vud, Uu, Uu, Uu^Br/, Uu^Br/, Uu^Br\, Uu
Uu, Xom, Xom, Xu, Xu, Uh, Uu, Uu, Ur, Uu^Tf, Xu, Xu, Xu, Uu, Uu, Uu, Xu, Xu, Xu, Xu, Xu, Xu, Xu, Urb, Ur^Br|, Uu, Uu^Br/, Uu^Br/, Uu, Uu^Br\, Uu^Br\, Uu^Br/, Uu, Uu, Uu, Uu^Br\
Uue, Xom, Xom, Xu, Xu, Xu, Xu, Uu^Ii, Ur, Uu^Tf, Uu, Xu, Uu^Vu, Uu, Uu^Tfi, Xu, Xu, Xu, Xu, Xu, Xu, Xu, Uh, Urb, Ur^Br|, Uu^Br/, Uu, Uu, Xu, Xu, Xu, Uu, Uu, Uu, Uu, Uu
Uue, Uue, Uue, Xom, Xom, Xu, Xu, Xu, Uu^Tf, Ur, Ur, Ur, Uu, Uu, Uu, Xu, Xu, Xu, Uh, Uu^Vu, Uh, Xu, Uh, Urb, Ur^Br|, Uu, Uu, Uu, Xu, Xu, Xu, Uu, Uu, Uu, Uu, Uu
Qxu, Qxe, Qxe, Uue, Uue, Xom, Xom, Xu, Xu, Uu, Uu, Uu, Uh, Uh, Uh, Uu, Uu, Uh, Uu, Uu, Uh, Uh, Uu, Urb, Ur^Br|, Uu, Uu, Xu, Xu, Xu, Xu, Xu, Xu, Uu, Uu, Uu
Qxu, Qxe, Qxe, Uue, Uue, Uue, Xom, Xu, Xu, Uu^Tf, Uu, Uh, Ur, Uh, Uu, Uu, Uu, Uu, Uu, Uu, Uu, Uu, Urb, Urb, Ur^Br/, Uu, Uu, Xu, Xu, Xu, Xu, Xu, Xu, Xu, Uu, Uu
Qxu, Qxu, Qxu, Qxe, Uue, Uue, Uue, Xom, Xu, Xu, Xu, Uu, Uu, Ur, Uu, Uu, Uu, Uu, Uu, Uu, Urb, Urb, Ur^Br/, Ur^Br/, Uu, Uu, Uu, Xu, Xu, Xu, Uu^Vu, Xu, Xu, Xu, Uu, Uu
Qxu, Qxu, Qxe, Qxe, Uue, Uue, Xom, Xom, Xu, Xu, Xu, Uu^Vu, Uu, Ur, Uh, Uh, Xu, Xu, Xu, Urb, Ur^Br|, Ur^Br/, Xu, Uu, Uu, Uu, Uu, Uu, Uu, Uu, Uu, Uu, Uu, Uu, Uu, Uu
Qxu, Qxu, Qxu^Bp|, Qxu^Bp/, Xom, Uue, Xom, Xu, Xu, Xu, Uh, Uu, Uu, Ur, Uh, Xu, Xu, Xu, Xu, Urb, Ur^Br|, Xu, Xu, Xu, Uu^Vu, Uu, Uu, Uu, Uu, Uu, Xu, Xu, Xu, Uu, Uu, Uu
Qxu, Qxu, Qxu^Bp|, Xu, Xu, Xom, Xu, Xu, Xu, Uh, Ur, Ur, Uu, Uh, Xu, Xu, Xu, Xu, Xu, Urb, Ur^Br|, Xu, Xu, Xu, Xu, Uu, Uu, Uu, Xu, Xu, Xu, Xu, Xu, Uu, Uu, Uu
Qxu, Qxu, Qxu^Bp|, Xu, Xu, Xu, Xu, Xu, Uh, Uh, Ur, Uu, Xu, Xu, Xu, Xu, Xu, Xu, Xu, Urb, Ur^Br|, Xu, Xu, Xu, Xu, Xu, Uu, Uu, Xu, Xu, Xu, Xu, Xu, Uu, Uu, Uu
Uu, Qxu, Uu, Xu, Xu, Xu, Xu, Xu, Uu^Vu, Uu, Ur, Uu^Vu, Xu, Xu, Xu, Xu, Uu^Tf, Xu, Uh, Urb, Ur^Br|, Uu^Tfi, Uu^Tf, Xu, Xu, Xu, Uu, Uu, Xu, Xu, Xu, Xu, Uu^Vu, Uu, Uu, Uu
Uu, Uu, Uu, Xu, Xu, Xu, Xu, Xu, Uu, Ur, Uu, Uu, Xu, Xu, Xu, Uu^Tf, Uu, Uh, Uu, Urb, Ur^Br|, Uu, Uu, Uu, Uu, Uu, Uu, Uu, Xu, Xu, Xu, Xu, Uu, Uu, Uu, Uu
Uu, Ur, Ur, Uu, Uu, Xu, Ur, Ur, Xu, Uu, Uu, Uu, Xu, Xu, Xu, Uu, Uu, Uu, Urb, Urb, Ur^Br/, Uu, Uu, Uu, Uu, Uu, Uu, Xu, Xu, Xu, Xu, Xu, Uu, Uu, Xu, Xu
Uu, Uu, Uu, Uu, Uu, Uu, Xu, Xu, Xu, Xu, Uu, Uh, Uh, Xu, Uh, Uu, Urb, Urb, Ur^Br/, Ur^Br/, Uu^Br\, Uu, Uu, Uu, Uu, Uu, Uu, Xu, Xu, Xu, Uu, Uu, Uu, Uu, Xu, Xu
Xu, Uu, Uu, Uu, Ur, Xu, Xu, Xu, Xu, Xu, Xu, Uu, Uu, Uh, Urb, Urb, Ur^Br/, Ur^Br/, Uu, Uu, Uu, Uu^Br\, Uu^Br\, Uu, Uu, Uu, Uu, Xu, Xu, Xu, Uu^Vu, Uu, Uu, Uu, Uu, Xu
Xu, Xu, Xu, Uu, Ur, Xu, Xu, Xu, Xu, Xu, Xu, Uu, Urb, Urb, Ur^Br/, Ur^Br/, Xu, Xu, Xu, Uu, Uu, Uh, Uh, Uu^Br\, Uu^Br\, Uu, Uu, Xu, Xu, Xu, Xu, Xu, Xu, Uu, Uu, Uu
Xu, Xu, Xu, Uu, Ur, Uu, Uu^Vu, Uh, Uh, Xu, Uh, Uh, Urb, Ur^Br/, Xu, Xu, Xu, Xu, Xu, Uu, Uu, Uu^Emf, Uh, Uu, Uu, Uu^Br\, Uu^Br\, Xu, Xu, Xu, Xu, Xu, Xu, Uu, Uu, Uu
Xu, Xu, Xu, Xu, Uu, Uu, Ur, Uu, Ur, Uu^Vud, Uu, Uu, Urb, Uu^Br|, Xu, Xu, Xu, Xu, Uu, Uu, Uu^Emf, Uu^Emf, Uu^Emf, Uh, Uu, Uu, Uu, Uu^Br\, Uu^Br|, Uu^Vu, Xu, Xu, Xu, Xu, Uu, Uu
Xu, Xu, Xu, Xu, Uu, Ur, Uu, Ur, Ur, Ur, Ur, Uu, Urb, Uu^Br|, Uu, Xu, Uu^Vud, Uu, Uu, Uu, Uu, Uu, Uu, Uu, Xu, Uu, Uu, Uu, Uu^Br\, Uu, Uu, Xu, Xu, Xu, Uu^Br/, Uu^Br/
Xu, Xu, Xu, Uu, Uu, Uu, Uh, Uh, Uh, Uu, Uu, Ur, Urb, Uu^Br|, Uu, Uu, Uu, Uu, Uu^Vud, Uu, Uu, Uu, Xu, Xu, Xu, Xu, Uu, Uu, Uu, Uu^Br\, Uu^Br\, Uu, Uu^Br/, Uu^Br/, Uu, Uu
Xu, Xu, Qxu, Uu, Xu, Xu, Xu, Xu, Xu, Uu^Vud, Uh, Uu, Urb, Uu^Br|, Uu, Uu, Uu, Uu, Uu, Uu, Xu, Xu, Xu, Xu, Xu, Xu, Uu, Uu, Uu, Uu, Uu, Uu^Br/, Uu, Uu, Xu, Uu
Qxu, Qxu, Qxu, Qxu, Xu, Xu, Xu, Xu, Xu, Uh, Uh, Uu, Urb, Uu^Br|, Uu, Uu, Cud, Uu, Uu, Uu, Xu, Xu, Xu, Xu, Xu, Xu, Xu, Uu, Uu, Uu, Uu, Uu, Xu, Xu, Xu, Xu
Qxu, Qxu, Qxu, Qxu, Xu, Xu, Xu, Xu, Xu, Xu, Uh, Uu, Urb, Uu^Br|, Uu, Cud, 1 Kud, Cud, Uu, Uu^Vud, Xu, Xu, Xu, Xu, Xu, Xu, Xu, Xu, Xu, Uu, Xu, Uu^Vu, Xu, Xu, Xu, Xu
Qxu, Qxu, Qxu, Qxu, Xu, Xu, Xu, Xu, Xu, Xu, Xu, Uu, Urb, Uu^Br|, Uu, Cud, Cud, Cud, Xu, Xu, Xu, Xu, Xu, Xu, Xu, Xu, Xu, Xu, Xu, Xu, Xu, Xu, Xu, Xu, Xu, Xu
Qxu, Qxu, Qxu, Qxu, Uu, Xu, Xu, Xu, Xu, Xu, Xu, Uu, Urb, Uu^Br|, Uu, Uu, Uu, Uu, Xu, Xu, Xu, Xu, Xu, Xu, Xu, Xu, Xu, Xu, Xu, Xu, Xu, Xu, Xu, Xu, Xu, Xu
