border_size=1
usage=map

Xu, Xu, Xu, Xu, Xu, Xu, Xu, Xu, Xu, Xu, Xu, Xu, Xu, Xu, Xu, Xu, Xu, Xu, Xu, Xu, Xu, Xu, Xu, Xu, Xu, Xu, Xu, Xu, Xu, Xu, Xu, Xu, Xu, Uue^Ii, Uue^Ii, Uue^Ii, Xu, Xu, Xu, Xu, Xu, Xu, Xu, Xu, Xu, Xu, Xu, Xu, Xu, Xu, Xu, Xu, Xu, Xu, Xu, Xu, Xu, Wo, Wo, Wo, Xu, Xu
Xu, Xu, Xu, Xu, Xu, Xu, Xu, Xu, Xu, Xu, Xu, Xu, Xu, Xu, Xu, Xu, Xu, Xu, Xu, Xu, Xu, Xu, Xu, Xu, Xu, Xu, Xu, Xu, Xu, Xu, Xu, Xu, Xu, Uue^Ii, Uue, Uue^Ii, Xu, Xu, Xu, Xu, Xu, Xu, Xu, Xu, Xu, Xu, Xu, Xu, Xu, Xu, Xu, Xu, Xu, Xu, Xu, Xu, Xu, Wo, Wo, Wo, Xu, Xu
Xu, Xu, Xu, Xu, Xu, Xu, Xu, Xu, Xu, Xu, Xu, Xu, Xu, Xu, Xu, Xu, Xu, Xu, Xu, Xu, Xu, Xu, Xu, Xu, Xu, Xu, Xu, Xu, Xu, Xu, Xu, Xu, Uue, Uue, Ce, Uue, Uue, Xu, Xu, Xu, Xu, Xu, Xu, Xu, Xu, Xu, Xu, Xu, Xu, Xu, Xu, Xu, Xu, Xu, Xu, Xu, Xu, Wo, Wog, Wo, Xu, Xu
Xu, Xu, Xu, Xu, Xu, Xu, Xu, Xu, Xu, Xu, Xu, Xu, Xu, Xu, Xu, Xu, Xu, Xu, Xu, Xu, Xu, Xu, Xu, Xu, Xu, Xu, Xu, Xu, Xu, Xu, Xu, Xu, Uue, Ce, 1 Ke, Ce, Uue, Xu, Xu, Xu, Xu, Xu, Xu, Xu, Xu, Xu, Xu, Xu, Xu, Xu, Uu^Tf, Xu, Uu^Tf, Xu, Xu, Xu, Xu, Wog, Wog, Wog, Xu, Xu
Xu, Xu, Xu, Xu, Xu, Xu, Xu, Xu, Xu, Xu, Xu, Xu, Xu, Xu, Xu, Xu, Xu, Xu, Xu, Xu, Xu, Xu, Xu, Xu, Xu, Xu, Xu, Xu, Xu, Xu, Uu^Vu, Xu, Uu, Ce, Ce, Ce, Ur, Uue, Uu^Vu, Xu, Xu, Xu, Xu, Xu, Xu, Xu, Uu, Xu, Uu, Uu, Uu, Uu^Tf, Uu, Uu^Tf, Xu, Xu, Xu, Wwg, Wog, Wog, Xu, Xu
Xu, Xu, Xu, Xu, Xu, Xu, Xu, Xu, Xu, Xu, Xu, Xu, Xu, Xu, Xu, Xu, Xu, Xu, Xu, Xu, Xu, Xu, Xu, Xu, Xu, Xu, Xu, Xu, Xu, Uu, Ur, Ur, Ur, Ur, Xu, Uue, Uu, Ur, Uue, Xu, Xu, Xu, Uu, Uu, Uu, Uu, Uu, Uu, Ur, Ur, Uu, Uu, Uu, Uu, Uu, Uh, Wwg, Wwg, Wog, Wog, Xu, Xu
Xu, Xu, Xu, Xu, Xu, Xu, Xu, Xu, Xu, Xu, Xu, Xu, Xu, Xu, Xu, Xu, Uu, Uu^Tf, Uu^Tf, Uu^Tf, Uu, Xu, Xu, Xu, Xu, Xu, Xu, Xu, Ur, Ur, Uu, Uu, Uu, Uu, Xu, Xu, Uu, Ur, Ur, Uu, Uu, Uu, Ur, Ur, Ur, Ur, Ur, Ur, Uu, Uu, Xu, Uu, Uu, Uu, Uh, Uu, Wwg, Wog, Wwg, Xu, Xu, Xu
Xu, Xu, Xu, Xu, Xu, Xu, Xu, Xu, Xu, Xu, Xu, Xu, Xu, Xu, Uu, Uu, Ur, Uu, Ur, Uu, Ur, Uu, Uu, Xu, Xu, Xu, Xu, Uu, Ur, Uu, Xu, Xu, Xu, Xu, Xu, Xu, Uu, Uu, Ur, Ur, Ur, Ur, Uu, Uu, Uu, Ur, Uu, Xu, Xu, Xu, Xu, Xu, Xu, Uh, Xu, Uh, Wwg, Wog, Wwg, Xu, Xu, Xu
Xu, Xu, Xu, Xu, Xu, Xu, Uu, Uu^Vu, Xu, Xu, Xu, Xu, Uu, Uu, Ur, Ur, Uu, Ur, Uu, Ur, Uu, Ur, Uu, Xu, Xu, Xu, Uu, Uu, Ur, Uu, Xu, Xu, Xu, Xu, Xu, Xu, Xu, Uu, Ur, Uu, Xu, Uu, Xu, Xu, Uh, Ur, Ur, Xu, Xu, Xu, Xu, Xu, Xu, Xu, Xu, Uh, Wwg, Wog, Wwg, Xu, Xu, Xu
Xu, Xu, Xu, Xu, Xu, Uu, Xu, Uu, Xu, Xu, Xu, Xu, Uu, Ur, Uu, Uu, Xu, Xu, Xu, Uu, Uu, Ur, Ur, Uu, Uu, Uu, Ur, Ur, Uu, Uu, Xu, Xu, Xu, Xu, Xu, Xu, Xu, Uu, Ur, Uu, Xu, Xu, Xu, Xu, Xu, Uh, Ur, Uu, Uu, Xu, Xu, Xu, Xu, Xu, Xu, Xu, Wwg, Wog, Wwg, Xu, Xu, Xu
Xu, Xu, Xu, Xu, Xu, Uu, Uu, Xu, Xu, Xu, Uu, Xu, Uu, Ur, Uu, Xu, Xu, Xu, Xu, Xu, Ur, Ur, Uu, Ur, Ur, Ur, Uu, Uu, Uu^Tf, Xu, Xu, Xu, Xu, Xu, Xu, Xu, Uu, Uu, Ur, Uu, Xu, Xu, Xu, Xu, Xu, Uh, Uu, Ur, Ur, Uu, Uu, Uu, Uu, Uh, Uh, Uu^Tf, Wwg, Wog, Wwg, Xu, Xu, Xu
Xu, Xu, Xu, Xu, Xu, Xu, Uu, Uu, Uu, Uu, Ur, Uu, Ur, Ur, Uu, Xu, Xu, Xu, Uu, Uu, Ur, Uu, Xu, Uu, Uu, Uu, Xu, Uu^Tf, Xu, Xu, Xu, Xu, Xu, Xu, Xu, Uu, Ur, Ur, Xu, Xu, Xu, Xu, Xu, Xu, Xu, Xu, Xu, Uu, Uu, Uu, Uu, Ur, Ur, Uu, Uu, Uh, Wwg, Wog, Wwg, Xu, Xu, Xu
Xu, Xu, Xu, Xu, Xu, Xu, Uu, Uu, Ur, Ur, Uu, Ur, Uu, Uu, Xu, Xu, Xu, Xu, Uu, Ur, Uu, Uu, Xu, Xu, Xu, Xu, Xu, Xu, Xu, Xu, Xu, Xu, Xu, Xu, Uu, Uu, Ur, Uu, Xu, Xu, Xu, Xu, Xu, Xu, Xu, Xu, Xu, Uu, Uu, Xu, Xu, Uu, Uu, Uu, Uh, Uu^Tf, Wwg, Wwg, Wwg, Xu, Xu, Xu
Xu, Xu, Xu, Xu, Xu, Uu, Ur, Ur, Uu, Uu, Uu, Uu, Xu, Xu, Xu, Xu, Xu, Uu, Ur, Ur, Uu, Xu, Xu, Xu, Xu, Xu, Uu, Uu^Vu, Uu, Xu, Xu, Xu, Xu, Uu, Ur, Ur, Uu, Uu, Xu, Xu, Xu, Xu, Xu, Xu, Xu, Xu, Uu, Uu, Uh, Xu, Xu, Xu, Xu, Xu, Xu, Xu, Wwg, Wwg, Wwg, Xu, Xu, Xu
Xu, Xu, Xu, Xu, Xu, Uu, Ur, Uu, Xu, Uu, Xu, Xu, Xu, Xu, Xu, Xu, Xu, Uu, Ur, Uu, Xu, Xu, Xu, Xu, Xu, Xu, Uu^Vu, Uu, Uu, Xu, Xu, Xu, Xu, Uu, Ur, Uu, Xu, Xu, Xu, Xu, Xu, Xu, Xu, Xu, Xu, Xu, Uu, Uu, Uu^Tf, Xu, Xu, Xu, Xu, Xu, Xu, Xu, Wwg, Wog, Wwg, Xu, Xu, Xu
Xu, Xu, Xu, Xu, Xu, Uu, Ur, Uu, Xu, Xu, Xu, Xu, Xu, Xu, Xu, Xu, Xu, Uu, Ur, Uu, Xu, Xu, Xu, Xu, Xu, Xu, Xu, Uu, Xu, Xu, Xu, Xu, Uu, Uu, Ur, Uu, Xu, Xu, Xu, Xu, Uu^Vu, Uu^Tf, Uu^Tf, Xu, Xu, Xu, Uu, Uu, Uu^Tf, Xu, Xu, Xu, Xu, Xu, Xu, Xu, Uh, Wog, Wwg, Xu, Xu, Xu
Xu, Xu, Xu, Xu, Uu, Uu, Ur, Uu, Xu, Xu, Xu, Xu, Xu, Xu, Xu, Xu, Xu, Uu^Vu, Uu, Ur, Uu, Xu, Uu, Xu, Uu, Xu, Xu, Uu, Xu, Xu, Xu, Xu, Uu, Ur, Uu, Uu, Xu, Xu, Xu, Xu, Uu, Uu, Uu, Uu, Uu, Uu, Xu, Xu, Xu, Xu, Xu, Xu, Xu, Xu, Wwg, Uh, Wog, Wog, Wwg, Xu, Xu, Xu
Xu, Xu, Xu, Xu, Uu, Uu, Ur, Uu, Xu, Xu, Xu, Xu, Xu, Xu, Xu, Xu, Xu, Xu, Xu, Ur, Ur, Uu, Uu, Uu, Uu, Uu, Uu, Uu, Xu, Xu, Xu, Xu, Xu, Ur, Uu, Xu, Xu, Xu, Xu, Xu, Xu, Uu, Uu^Tf, Uu, Uu, Xu, Xu, Xu, Xu, Xu, Xu, Xu, Xu, Wwg, Wwg, Wog, Wog, Wwg, Uh, Xu, Xu, Xu
Xu, Xu, Xu, Xu, Uu^Vu, Uu, Ur, Uu, Uu, Xu, Xu, Xu, Uu^Vu, Xu, Xu, Xu, Xu, Xu, Xu, Uu, Uu, Ur, Ur, Ur, Uu, Uu, Xu, Xu, Xu, Xu, Xu, Xu, Xu, Ur, Ur, Uu, Uu, Xu, Xu, Xu, Xu, Uu^Tf, Xu, Uu^Tf, Xu, Xu, Xu, Xu, Xu, Xu, Xu, Xu, Wwg, Wwg, Wog, Wog, Wog, Uh, Xu, Xu, Xu, Xu
Xu, Xu, Xu, Xu, Xu, Uu, Uu, Ur, Uu^Tf, Uu, Uu, Uu, Ur, Uu, Uu, Xu, Xu, Xu, Xu, Xu, Xu, Uu, Uu, Uu, Xu, Xu, Xu, Xu, Xu, Xu, Xu, Xu, Uu, Uu, Ur, Ur, Ur, Uu, Xu, Xu, Xu, Xu, Xu, Xu, Xu, Xu, Xu, Xu, Xu, Xu, Xu, Wwg, Wwg, Wwg, Wwg, Wog, Xu, Xu, Xu, Xu, Xu, Xu
Xu, Xu, Xu, Xu, Xu, Xu, Uu, Uu^Tf, Uu^Tf, Ur, Ur, Ur, Uu, Ur, Uu, Xu, Xu, Xu, Xu, Xu, Xu, Xu, Xu, Xu, Xu, Xu, Xu, Xu, Xu, Xu, Uu, Uu, Ur, Ur, Xu, Uu, Ur, Uu, Uu, Xu, Xu, Xu, Xu, Xu, Xu, Xu, Xu, Xu, Xu, Xu, Uh, Uh, Wwg, Wwg, Xu, Xu, Xu, Xu, Xu, Xu, Xu, Xu
Xu, Xu, Xu, Xu, Xu, Xu, Ur, Ur, Uu, Uu, Uu, Uu, Uu, Ur, Ur, Uu^Tf, Xu, Xu, Xu, Xu, Xu, Xu, Xu, Xu, Xu, Xu, Xu, Xu, Xu, Xu, Uu, Ur, Uu, Uu, Xu, Uu, Uu, Ur, Ur, Xu, Uh, Xu, Xu, Xu, Xu, Xu, Xu, Xu, Xu, Xu, Wwg, Wwg, Uh, Xu, Xu, Xu, Xu, Xu, Xu, Xu, Xu, Xu
Xu, Xu, Xu, Xu, Uu, Uu, Ur, Uu, Xu, Xu, Xu, Xu, Xu, Uu, Ur, Uu, Uu, Uu, Uu, Uu, Uu, Xu, Xu, Xu, Xu, Xu, Xu, Xu, Uu^Vu, Uu, Ur, Ur, Uu, Xu, Xu, Xu, Xu, Uu, Ur, Uu^Tf, Uu^Tf, Uu^Tf, Uu, Xu, Xu, Xu, Xu, Uu^Tf, Uu, Uu, Wwg, Uh, Xu, Xu, Xu, Xu, Xu, Xu, Xu, Xu, Xu, Xu
Xu, Xu, Xu, Xu, Uu, Uu, Ur, Uu, Xu, Xu, Xu, Xu, Xu, Uu^Tf, Uu^Tf, Ur, Ur, Ur, Ur, Ur, Ur, Uu^Vu, Xu, Xu, Xu, Xu, Xu, Xu, Uu, Ur, Uu, Uu, Xu, Xu, Xu, Xu, Xu, Xu, Uh, Ur, Ur, Uu, Uu, Uh, Xu, Xu, Xu, Uu^Tf, Uu, Uu, Uu, Wwg, Wwg, Xu, Xu, Xu, Xu, Xu, Xu, Xu, Xu, Xu
Xu, Xu, Xu, Uu^Vu, Ur, Ur, Uu, Uu, Xu, Xu, Xu, Xu, Xu, Uh, Uu^Tf, Uu, Uu, Ur, Uu, Uu, Ur, Uu, Uu, Xu, Xu, Xu, Xu, Xu, Uu, Ur, Uu, Xu, Xu, Xu, Xu, Xu, Xu, Xu, Xu, Uh, Uh, Ur, Ur, Uh, Xu, Xu, Xu, Uu, Ur, Uu, Xu, Wwg, Wwg, Wwg, Wwg, Xu, Wwg, Ww^Vm, Wwg, Xu, Xu, Xu
Xu, Xu, Uh, Uu, Uu, Uu, Xu, Xu, Xu, Xu, Uu, Uu^Vu, Uu, Xu, Xu, Xu, Xu, Uu, Xu, Xu, Uu, Ur, Uu, Uu, Xu, Xu, Uu, Uu, Ur, Ur, Xu, Xu, Xu, Xu, Xu, Xu, Xu, Xu, Xu, Xu, Xu, Uh, Uu, Ur, Uu, Xu, Ur, Ur, Xu, Xu, Xu, Wwg, Wwg, Wwg, Wog, Wwg, Wog, Wwg, Wwg, Wwg, Wwg, Xu
Xu, Xu, Uh, Uh, Uh, Uh, Xu, Xu, Xu, Uu^Vu, Uu, Uu, Uu, Uu, Uu^Vu, Xu, Xu, Xu, Xu, Xu, Uu, Ur, Ur, Uu, Uu, Uu, Ur, Ur, Uu, Xu, Xu, Xu, Xu, Xu, Xu, Xu, Xu, Xu, Xu, Xu, Xu, Xu, Uu, Ur, Ur, Ur, Uu, Uu, Xu, Xu, Xu, Xu, Wwg, Wog, Wog, Wog, Uh, Wog, Wog, Wwg, Wwg, Xu
Xu, Xu, Uh, Uh, Uh, Xu, Xu, Xu, Xu, Uu, Uu, Uu, Uu, Uu, Uu, Xu, Xu, Xu, Xu, Xu, Uu, Uu, Uu, Ur, Ur, Ur, Ur, Uu, Uu, Xu, Xu, Xu, Xu, Xu, Xu, Xu, Xu, Xu, Xu, Xu, Xu, Xu, Xu, Uh, Uh, Ur, Uh, Xu, Xu, Xu, Xu, Xu, Wwg, Wwg, Wog, Uh, Uh, Uh, Wog, Wog, Wwg, Xu
Xu, Xu, Uu, Uh, Uu, Xu, Xu, Xu, Xu, Uu^Vu, Uu, Uu, Uu, Uu, Uu^Vu, Xu, Xu, Xu, Xu, Xu, Uu, Uu, Uu, Uu, Xu, Uu, Uu, Ur, Ur, Uu, Xu, Xu, Xu, Xu, Xu, Xu, Xu, Xu, Uh, Xu, Xu, Xu, Xu, Xu, Uh, Ur, Uh, Xu, Xu, Xu, Xu, Xu, Xu, Wwg, Wog, Uh, Wog, Wog, Wwg, Wwg, Xu, Xu
Xu, Xu, Uu, Uu, Ur, Xu, Xu, Xu, Xu, Xu, Uu, Uu, Uu, Uu, Xu, Xu, Xu, Xu, Xu, Xu, Uu, Uu^Vu, Xu, Xu, Xu, Xu, Xu, Uu, Ur, Uu, Xu, Xu, Xu, Xu, Xu, Xu, Uh, Uh, Uu, Uu, Uu, Xu, Uu^Tf, Xu, Uu, Ur, Uu, Xu, Xu, Xu, Xu, Xu, Xu, Wwg, Wwg, Wog, Wwg, Wwg, Wwg, Xu, Xu, Xu
Xu, Xu, Xu, Uu, Ur, Ur, Uu, Uh, Uu, Uu, Ur, Ur, Uu, Uu, Uu, Xu, Xu, Xu, Xu, Xu, Uu, Xu, Xu, Xu, Xu, Xu, Xu, Uu, Ur, Uu, Uu, Xu, Xu, Xu, Xu, Uh, Uh, Uu, Ur, Ur, Ur, Uu, Ur, Uu, Ur, Ur, Uu, Xu, Xu, Xu, Xu, Xu, Xu, Xu, Xu, Wwg, Xu, Xu, Xu, Wwg, Xu, Xu
Xu, Xu, Xu, Xu, Uu, Ur, Uu, Ur, Ur, Ur, Uu, Uu, Xu, Xu, Xu, Uu, Xu, Xu, Ur, Uu, Xu, Xu, Xu, Xu, Xu, Xu, Xu, Uu, Uu, Ur, Uu, Xu, Xu, Xu, Xu, Uh, Uu, Ur, Uu, Uu, Uu, Ur, Uh, Ur, Uu, Uu, Xu, Xu, Xu, Xu, Xu, Xu, Xu, Xu, Wwg, Wwg, Xu, Xu, Xu, Wwg, Xu, Xu
Wog, Xu, Xu, Xu, Xu, Uu, Uu^Vu, Uu, Uu, Ur, Ur, Xu, Xu, Xu, Xu, Uu, Ur, Ur, Uu^Tf, Xu, Xu, Xu, Xu, Xu, Xu, Xu, Xu, Xu, Uu, Ur, Uu, Uu^Tf, Xu, Xu, Xu, Uu, Uu, Ur, Xu, Xu, Xu, Uh, Uh, Uh, Xu, Xu, Xu, Xu, Xu, Xu, Xu, Xu, Wwg, Xu, Wwg, Wwg, Xu, Xu, Wwg, Wwg, Xu, Xu
Xu, Wog, Wog, Wog, Wog, Xu, Xu, Xu, Xu, Uu, Uu, Xu, Xu, Xu, Xu, Ur, Xu, Xu, Xu, Xu, Xu, Xu, Xu, Xu, Xu, Xu, Xu, Xu, Uu, Ur, Uu, Uu^Tf, Xu, Xu, Xu, Uu, Uu, Ur, Uh, Xu, Xu, Xu, Xu, Xu, Xu, Xu, Xu, Xu, Xu, Xu, Wwg, Wwg, Wwg, Wwg, Xu, Xu, Xu, Xu, Wwg, Wwg, Xu, Xu
Wog, Wog, Wog, Wog, Xu, Wog, Wog, Xu, Xu, Xu, Xu, Ur, Ur, Ur, Ur, Uu, Xu, Xu, Xu, Xu, Xu, Xu, Xu, Xu, Xu, Xu, Xu, Xu, Uu, Ur, Uu, Xu, Xu, Xu, Xu, Uh, Uh, Ur, Uu^Vu, Xu, Xu, Xu, Xu, Xu, Xu, Xu, Xu, Xu, Xu, Xu, Wwg, Xu, Xu, Xu, Xu, Xu, Xu, Xu, Wwg, Wwg, Wwg, Xu
Wog, Wog, Xu, Xu, Xu, Xu, Xu, Wwg, Wwg, Xu, Xu, Ur, Xu, Xu, Ur, Ur, Uu^Vu, Xu, Xu, Xu, Xu, Xu, Xu, Xu, Xu, Xu, Xu, Xu, Uu, Ur, Uu, Xu, Xu, Xu, Xu, Xu, Uh, Ur, Uu, Uh, Uu, Xu, Uu^Tf, Uh, Uu^Tf, Xu, Xu, Xu, Wwg, Wwg, Xu, Xu, Xu, Xu, Xu, Xu, Xu, Wwg, Wwg, Ww^Vm, Wwg, Xu
Xu, Xu, Xu, Xu, Uu^Vu, Xu, Xu, Xu, Wwg, Xu, Xu, Xu, Xu, Uu, Ur, Ur, Uu, Xu, Xu, Xu, Xu, Xu, Xu, Xu, Uh, Uh, Uu, Uu, Ur, Ur, Uh, Xu, Xu, Xu, Xu, Xu, Xu, Ur, Ur, Uu, Ur, Uu, Ur, Uu^Tf, Uu, Uu, Xu, Xu, Xu, Wwg, Wwg, Xu, Xu, Xu, Xu, Xu, Wwg, Wwg, Wwg, Wwg, Xu, Xu
Xu, Xu, Uu^Vu, Uu, Uu, Uu, Uu^Emf, Xu, Wwg, Xu, Xu, Xu, Xu, Uu, Ur, Uu, Uh, Xu, Xu, Xu, Xu, Xu, Xu, Xu, Uu, Uu, Ur, Ur, Uh, Uh, Xu, Xu, Xu, Xu, Xu, Xu, Xu, Uu^Tf, Ur, Ur, Uu, Ur, Uu^Tf, Ur, Ur, Uu, Uu, Xu, Uu^Emf, Wwg, Wwg, Wwg, Xu, Xu, Xu, Wwg, Wwg, Xu, Wwg, Wwg, Xu, Xu
Xu, Xu, Uu, Uu, Co, Uu, Uu, Uu^Emf, Wwg, Wwg, Uh, Uu^Vu, Uu, Uu, Ur, Uh, Xu, Xu, Xu, Xu, Xu, Xu, Xu, Xu, Uu, Ur, Uh, Uh, Xu, Xu, Xu, Xu, Xu, Xu, Xu, Xu, Xu, Xu, Ur, Uu, Xu, Uu^Tf, Xu, Xu, Uu, Ur, Ur, Uu, Uu, Uu^Emf, Uu^Emf, Wwg, Xu, Xu, Xu, Wwg, Xu, Xu, Wwg, Wwg, Xu, Xu
Xu, Xu, Uu, Co, 3 Ko, Co, Uu, Uu^Emf, Wwg, Uh, Ur, Ur, Ur, Ur, Uu, Uh, Xu, Xu, Xu, Xu, Xu, Xu, Uh, Uh, Uu, Uu, Xu, Xu, Xu, Xu, Xu, Xu, Wwg, Xu, Xu, Xu, Xu, Uh, Ur, Uu, Xu, Xu, Xu, Xu, Uu^Vu, Uu, Co, Co, Co, Uu, Uu^Emf, Wwg, Wwg, Xu, Wwg, Wwg, Xu, Xu, Wwg, Xu, Xu, Xu
Xu, Xu, Uu, Co, Co, Co, Uu, Uu^Emf, Wwg, Uh, Uh, Uu, Uu, Uu, Xu, Xu, Xu, Xu, Xu, Xu, Xu, Xu, Uh, Uh, Uh, Uu, Xu, Xu, Xu, Xu, Wwg, Wwg, Wwg, Xu, Xu, Xu, Xu, Uh, Ur, Uu, Xu, Xu, Xu, Xu, Uu^Emf, Uu, Co, 2 Ko, Co, Uu, Uu^Emf, Wwg, Xu, Wwg, Xu, Xu, Xu, Xu, Wwg, Wwg, Xu, Xu
Xu, Xu, Xu, Uu, Uu, Uu, Uu^Emf, Uu^Emf, Wwg, Xu, Xu, Xu, Xu, Xu, Xu, Xu, Xu, Xu, Xu, Xu, Xu, Xu, Uh, Uh, Uh, Uh, Uh, Uh, Uh, Wwg, Wwg, Wwg, Wwg, Wwg, Xu, Xu, Xu, Uu, Ur, Uu, Xu, Xu, Xu, Xu, Uu^Emf, Uu^Emf, Uu, Co, Uu, Uu, Uu^Emf, Wwg, Wwg, Xu, Xu, Xu, Xu, Xu, Wog, Wog, Xu, Xu
Xu, Xu, Xu, Uu, Uu^Vu, Uu, Xu, Wwg, Xu, Xu, Xu, Xu, Xu, Xu, Xu, Xu, Xu, Xu, Uh, Xu, Wwg, Wwg, Wwg, Uh, Wwg, Wwg, Wwg, Uh, Wwg, Wwg, Wwg, Wwg, Wwg, Wwg, Xu, Xu, Xu, Uu, Ur, Uu, Xu, Xu, Xu, Xu, Xu, Uu^Emf, Uu, Uu, Uu^Vu, Uu, Xu, Xu, Wwg, Xu, Xu, Xu, Xu, Xu, Wog, Wog, Wog, Xu
Xu, Xu, Xu, Xu, Xu, Xu, Wog, Wwg, Xu, Xu, Xu, Xu, Xu, Xu, Xu, Xu, Uh, Uh, Wwg, Wwg, Wwg, Wwg, Wwg, Wwg, Uh, Uh, Uh, Wwg, Wwg, Wwg, Xu, Wwg, Xu, Xu, Xu, Xu, Uu, Uu, Ur, Uh, Xu, Xu, Xu, Xu, Xu, Xu, Xu, Uu, Xu, Xu, Xu, Xu, Wwg, Xu, Xu, Xu, Wog, Wog, Ww^Vm, Wog, Wog, Xu
Xu, Xu, Xu, Xu, Xu, Wog, Xu, Xu, Xu, Xu, Xu, Xu, Xu, Xu, Xu, Uh, Wwg, Wwg, Uh, Uh, Uh, Uh, Uh, Wwg, Uh, Uh, Uu, Xu, Xu, Xu, Xu, Xu, Xu, Xu, Xu, Xu, Ur, Ur, Uu, Uh, Uh, Xu, Xu, Xu, Xu, Xu, Xu, Xu, Xu, Xu, Xu, Xu, Xu, Wwg, Xu, Xu, Wog, Wog, Wog, Wog, Wog, Xu
Xu, Xu, Xu, Xu, Wwg, Wwg, Wwg, Xu, Xu, Xu, Xu, Xu, Xu, Xu, Uu^Tf, Uh, Wwg, Uu^Tf, Xu, Uh, Xu, Xu, Wwg, Wwg, Uh, Uu, Uu^Vu, Xu, Xu, Xu, Xu, Xu, Xu, Xu, Uu, Uu, Ur, Uu, Xu, Uu, Uu, Uu, Uu, Xu, Xu, Xu, Xu, Xu, Xu, Xu, Xu, Xu, Xu, Wwg, Xu, Xu, Wog, Wog, Wog, Wog, Wog, Wog
Xu, Xu, Xu, Xu, Wwg, Wog, Wwg, Wwg, Wwg, Xu, Xu, Xu, Xu, Uu^Tf, Wwg, Wwg, Uu^Tf, Uu^Tf, Xu, Xu, Xu, Xu, Wwg, Uh, Uu, Uu, Uu^Tf, Xu, Xu, Xu, Xu, Xu, Uh, Uu, Ur, Ur, Uu, Uu, Xu, Uu^Vu, Uu, Uu, Uu, Uu^Tf, Xu, Xu, Xu, Xu, Xu, Xu, Xu, Xu, Wog, Wwg, Xu, Xu, Wog, Wog, Wog, Wog, Wog, Wog
Xu, Xu, Xu, Wwg, Wog, Wog, Wwg, Wog, Wwg, Xu, Xu, Xu, Uu^Tf, Uu^Tf, Wwg, Uu^Tf, Xu, Xu, Xu, Xu, Xu, Xu, Wwg, Uh, Uu^Tf, Uu, Uu, Uu^Tf, Xu, Xu, Xu, Uh, Uu, Ur, Uu, Uu, Xu, Xu, Xu, Xu, Uu^Tf, Uu, Uu, Uu, Xu, Xu, Xu, Xu, Xu, Xu, Xu, Wog, Xu, Xu, Xu, Xu, Xu, Wog, Wog, Wog, Xu, Xu
Xu, Xu, Xu, Wwg, Wwg, Wwg, Xu, Wwg, Wog, Wwg, Wwg, Uh, Uh, Uu^Tf, Wwg, Wwg, Xu, Xu, Xu, Xu, Xu, Xu, Xu, Wwg, Wwg, Uu^Tf, Uu, Uu, Uh, Xu, Xu, Uh, Ur, Ur, Xu, Xu, Xu, Xu, Xu, Xu, Xu, Uu^Tf, Uu, Uu, Xu, Xu, Xu, Xu, Xu, Xu, Xu, Wog, Xu, Xu, Xu, Xu, Wog, Wog, Wog, Xu, Xu, Xu
Xu, Xu, Xu, Xu, Xu, Xu, Xu, Wwg, Wwg, Wog, Wwg, Wwg, Uh, Uh, Wwg, Wwg, Xu, Xu, Xu, Xu, Xu, Xu, Xu, Xu, Wwg, Uh, Uh, Uh, Uh, Xu, Xu, Uh, Ur, Uu, Xu, Xu, Xu, Xu, Xu, Xu, Xu, Uu^Tf, Uu, Uu, Xu, Xu, Xu, Xu, Xu, Xu, Xu, Wog, Wog, Xu, Xu, Xu, Wog, Wog, Xu, Xu, Xu, Xu
Xu, Xu, Xu, Xu, Xu, Xu, Xu, Xu, Xu, Wwg, Uh, Wwg, Wwg, Wwg, Xu, Xu, Xu, Xu, Xu, Xu, Xu, Xu, Xu, Xu, Xu, Wwg, Xu, Uh, Xu, Xu, Xu, Xu, Uu, Ur, Uu^Tf, Xu, Xu, Xu, Xu, Xu, Xu, Xu, Xu, Xu, Xu, Xu, Xu, Xu, Xu, Xu, Xu, Xu, Wog, Wog, Wog, Wog, Wog, Wog, Xu, Xu, Xu, Xu
Xu, Xu, Xu, Xu, Xu, Xu, Xu, Xu, Xu, Xu, Uh, Wwg, Wwg, Xu, Xu, Xu, Xu, Xu, Xu, Xu, Xu, Xu, Xu, Xu, Wwg, Wwg, Xu, Xu, Xu, Xu, Xu, Xu, Uu, Ur, Ur, Uu^Tf, Xu, Xu, Xu, Xu, Xu, Xu, Xu, Xu, Wwg, Xu, Xu, Xu, Xu, Xu, Xu, Xu, Wog, Wog, Wog, Wog, Xu, Xu, Xu, Xu, Xu, Xu
Xu, Xu, Xu, Xu, Xu, Xu, Xu, Xu, Xu, Xu, Uh, Wwg, Wwg, Xu, Uh, Xu, Xu, Xu, Xu, Xu, Xu, Xu, Wog, Wog, Xu, Xu, Xu, Xu, Xu, Xu, Xu, Xu, Xu, Uu, Ur, Uu, Uu, Xu, Xu, Xu, Xu, Xu, Xu, Xu, Xu, Wwg, Wwg, Wwg, Wog, Xu, Wog, Wog, Xu, Wog, Wog, Wog, Wog, Xu, Xu, Xu, Xu, Xu
Xu, Xu, Xu, Xu, Xu, Xu, Xu, Xu, Xu, Xu, Uh, Wwg, Wwg, Wwg, Wog, Uh, Uh, Xu, Xu, Xu, Xu, Xu, Wog, Xu, Xu, Xu, Xu, Xu, Xu, Xu, Xu, Xu, Xu, Uu, Ur, Ur, Uu, Xu, Xu, Xu, Xu, Xu, Xu, Xu, Xu, Wwg, Xu, Xu, Xu, Wog, Wog, Wog, Xu, Xu, Xu, Xu, Wog, Xu, Xu, Xu, Xu, Xu
Xu, Xu, Xu, Xu, Xu, Xu, Xu, Xu, Xu, Xu, Xu, Uh, Uh, Wog, Wog, Wog, Uh, Xu, Xu, Xu, Xu, Xu, Wog, Xu, Xu, Xu, Xu, Xu, Xu, Xu, Xu, Qxua, Qxua, Ur, Uu, Ur, Ur, Xu, Xu, Xu, Xu, Xu, Xu, Xu, Wwg, Wwg, Xu, Xu, Xu, Xu, Xu, Xu, Xu, Xu, Xu, Xu, Wog, Xu, Xu, Xu, Xu, Xu
Xu, Xu, Xu, Xu, Wog, Xu, Xu, Xu, Xu, Xu, Xu, Xu, Xu, Uh, Xu, Wog, Wog, Xu, Xu, Xu, Xu, Xu, Xu, Wog, Xu, Xu, Xu, Xu, Xu, Xu, Wwt, Wot, Qxua, Ur, Uu, Uu, Ur, Uu, Qxua, Xu, Xu, Xu, Xu, Xu, Wwt, Wwg, Wwg, Xu, Xu, Xu, Xu, Xu, Xu, Xu, Xu, Xu, Wog, Wog, Wog, Xu, Xu, Xu
Xu, Xu, Xu, Wog, Xu, Wog, Wog, Xu, Xu, Xu, Xu, Xu, Xu, Xu, Xu, Xu, Xu, Wog, Xu, Xu, Xu, Xu, Xu, Wot, Wot, Xu, Xu, Xu, Wwt, Wwt, Wwt, Wot, Wot, Qxua, Uu, Uu, Qxua, Qxua, Wot, Qxua, Wot, Xu, Xu, Xu, Wwt, Wwt, Xu, Xu, Xu, Xu, Xu, Xu, Xu, Xu, Wog, Wog, Xu, Xu, Xu, Wog, Wog, Xu
Wog, Wog, Wog, Wog, Xu, Xu, Xu, Wog, Xu, Xu, Xu, Xu, Xu, Xu, Xu, Xu, Wog, Wog, Wog, Xu, Xu, Xu, Wog, Wot, Xu, Wwt, Wwt, Wwt, Wwt, Wwt, Wot, Wwt, Wot, Qxua, Wwt, Qxua, Wot, Wot, Wot, Wot, Wwt, Wwt, Wwt, Wwt, Wwt, Wwt, Xu, Xu, Xu, Xu, Xu, Xu, Xu, Wog, Wog, Xu, Xu, Xu, Xu, Xu, Xu, Wog
Wog, Xu, Xu, Xu, Xu, Xu, Xu, Wog, Wog, Xu, Wog, Wog, Wog, Xu, Wog, Wog, Xu, Xu, Xu, Wog, Wog, Wog, Xu, Xu, Xu, Xu, Wwt, Wwt, Wot, Wot, Wot, Wot, Qxua, Qxua, Wwt, Qxua, Qxua, Wot, Wot, Wot, Wot, Wwt, Wwt, Wwt, Xu, Xu, Xu, Xu, Xu, Xu, Xu, Xu, Xu, Xu, Wog, Xu, Xu, Xu, Xu, Xu, Xu, Wog
Xu, Xu, Xu, Xu, Xu, Xu, Xu, Xu, Wog, Wog, Xu, Xu, Wog, Wog, Wog, Xu, Xu, Xu, Xu, Xu, Xu, Xu, Xu, Xu, Xu, Xu, Wwt, Wwt, Wot, Wot, Qxua, Qxua, Wot, Wot, Wwt, Wot, Wot, Qxua, Wot, Wot, Wot, Wot, Wwt, Xu, Xu, Xu, Xu, Xu, Xu, Xu, Xu, Xu, Xu, Xu, Xu, Wog, Xu, Xu, Xu, Xu, Xu, Xu
Xu, Xu, Xu, Xu, Xu, Xu, Wog, Wog, Xu, Wog, Xu, Xu, Xu, Wog, Wog, Xu, Xu, Xu, Xu, Xu, Xu, Xu, Xu, Xu, Xu, Xu, Wwt, Wot, Wot, Qxua, Wot, Qxua, Wot, Wot, Wwt, Wot, Wot, Qxua, Qxua, Wot, Qxua, Wot, Wwt, Xu, Xu, Xu, Xu, Xu, Xu, Xu, Xu, Xu, Xu, Xu, Xu, Wog, Wog, Xu, Xu, Xu, Xu, Xu
Xu, Xu, Wog, Xu, Wog, Wog, Xu, Wog, Xu, Xu, Xu, Xu, Xu, Xu, Wog, Xu, Xu, Xu, Xu, Xu, Xu, Xu, Xu, Xu, Xu, Xu, Wwt, Wot, Wot, Qxua, Wot, Qxua, Qxua, Wot, Wwt^Ns, Wot, Qxua, Qxua, Wot, Qxua, Wot, Wot, Wwt, Wwt, Wwt, Wwt, Wwt, Xu, Xu, Xu, Xu, Xu, Xu, Xu, Wog, Wog, Xu, Wog, Wog, Xu, Xu, Xu
Wog, Wog, Xu, Wog, Xu, Wog, Xu, Xu, Xu, Xu, Xu, Xu, Xu, Xu, Xu, Wog, Wwg, Xu, Xu, Xu, Xu, Wog, Wog, Wog, Wwt, Wwt, Wwt, Wwt, Wot, Wot, Qxua, Wot, Wot, Wot, Wot, Wot, Wot, Wot, Qxua, Wot, Wot, Wwt, Wwt, Xu, Xu, Xu, Xu, Wog, Wog, Xu, Wog, Wog, Wog, Wog, Xu, Wog, Xu, Xu, Xu, Wog, Xu, Xu
Xu, Xu, Xu, Xu, Xu, Wog, Xu, Xu, Xu, Xu, Xu, Xu, Xu, Xu, Xu, Xu, Wwg, Wwg, Wwg, Xu, Wog, Wog, Xu, Wog, Xu, Xu, Xu, Wwt, Wwt, Wot, Wot, Qxua, Wot, Wot, Wot, Wot, Wot, Qxua, Wot, Qxua, Wot, Wwt, Xu, Xu, Xu, Xu, Xu, Xu, Wwg, Wwg, Xu, Xu, Xu, Xu, Wog, Wog, Xu, Xu, Xu, Wog, Xu, Xu
Xu, Xu, Xu, Xu, Xu, Wog, Xu, Xu, Xu, Xu, Xu, Xu, Xu, Xu, Xu, Wwg, Wog, Xu, Xu, Wog, Xu, Xu, Xu, Xu, Wwg, Wwg, Wwt, Wwt, Wwt, Wwt, Wwt, Wot, Wwt, Wwt, Wwt, Wot, Wwt, Wot, Wwt, Wot, Xu, Xu, Xu, Xu, Xu, Xu, Xu, Xu, Xu, Wwg, Xu, Xu, Xu, Xu, Xu, Wog, Xu, Xu, Xu, Wog, Wog, Xu
Xu, Xu, Xu, Xu, Wog, Wog, Xu, Xu, Xu, Xu, Xu, Xu, Wog, Wog, Wog, Wog, Wog, Xu, Xu, Xu, Xu, Xu, Wwg, Wwg, Wwg, Wwt, Wwt, Wwt, Wwt, Xu, Xu, Wwt, Xu, Xu, Xu, Wwt, Xu, Wwt, Wwt, Wwt, Xu, Xu, Xu, Xu, Xu, Xu, Xu, Xu, Xu, Wog, Xu, Xu, Xu, Xu, Xu, Wog, Xu, Xu, Xu, Xu, Wog, Xu
Xu, Xu, Xu, Wog, Xu, Xu, Xu, Xu, Xu, Xu, Xu, Xu, Wog, Wog, Wog, Wog, Xu, Xu, Xu, Xu, Xu, Xu, Wwg, Wwg, Wwg, Wwg, Wwg, Wwg, Wwg, Xu, Xu, Xu, Xu, Xu, Xu, Xu, Xu, Wwt, Wwt, Wwt, Xu, Xu, Xu, Xu, Xu, Xu, Xu, Xu, Wog, Wog, Xu, Xu, Xu, Xu, Xu, Wog, Xu, Xu, Xu, Xu, Xu, Wog
