border_size=1
usage=map

Mm, Mm, Mm, Mm, Mm, Mm, Mm, Mm, Mm, Mm, Mm, Mm, Mm, Mm, Mm, Mm, Mm, Mm, Mm, Gs, Mm, Mm, Mm, Mm, Mm^Xm, Mm, Mm, Gs, Hhd^Fmw, Gs, Gll^Fmw, Gll, Gll, Gll, Gll, Gll, Hhd^Fmw, Gs, Mm, Mm, Mm, Mm, Mm, Mm, Mm, Mm
Mm, Mm, Mm, Mm, Mm, Mm, Mm, Mm, Mm, Mm, Mm^Xm, Mm^Xm, Mm, Mm, Mm, Mm, Mm, Mm, Mm, Mm^Xm, Mm^Xm, Mm, Mm, Mm, Mm, Mm, Mm, Mm, Hhd^Fmw, Hhd^Fmw, Gll^Fmw, Gll, Gll, Gll, Gll, Gll^Fmw, Gll^Fmw, Hhd^Fmw, Mm, Mm, Mm, Mm, Mm, Mm, Mm, Mm
Mm, Mm, Mm, Mm, Mm^Xm, Mm, Mm, Mm, Mm^Xm, Mm^Xm, Mm, Mm, Mm, Mm, Mm, Mm, Mm, Mm, Mm, Mm, Mm^Xm, Mm, Mm^Xm, Mm^Xm, Mm, Mm, Mm, Mm, Hhd^Fmw, Hhd^Fmw, Gll^Fmw, Gll, Gll, Re^Vct, Gll, Gll^Fmw, Gll^Fmw, Hhd^Fmw, Mm, Mm, Mm, Mm, Mm, Mm, Mm, Mm
Mm, Mm, Mm^Xm, Mm^Xm, Mm, Mm, Mm, Mm, Mm, Mm, Mm, Mm, Mm, Mm, Hhd, Mm, Mm, Mm, Mm, Mm, Mm, Mm^Xm, Mm, Mm, Mm, Mm, Mm, Mm, Hhd^Fmw, Hhd^Fmw, Gll^Fmw, Gll, Ce, Gll, Gll, Gll^Fmw, Gll^Fmw, Hhd^Fmw, Hhd^Fmw, Mm, Mm, Mm, Mm, Mm, Mm, Mm
Mm, Mm^Xm, Mm, Mm, Mm, Mm, Hhd, Uu^Vud, Hhd, Hhd, Hhd, Hhd, Hhd, Hhd, Hhd, Hhd, Hhd, Mm, Mm, Mm, Mm, Mm^Xm, Mm^Xm, Mm, Mm, Mm, Mm, Hhd^Fmw, Hhd^Fmw, Hhd^Fmw, Gll^Fmw, Ce, 1 Ke, Ce, Gll, Gll^Fmw, Gll^Fmw, Hhd^Fmw, Hhd^Fmw, Mm, Mm, Mm, Mm, Mm, Mm, Mm
Mm, Mm, Mm, Mm, Mm, Mm, Hhd, Hhd, Cud, Cud, Cud, Cud, Gd, Hhd, Gd^Es, Hhd, Hhd, Uu^Vud, Mm, Mm, Mm, Mm, Mm, Mm, Mm, Mm, Mm, Hhd^Fmw, Hhd^Fmw, Gll^Fmw, Gll, Ce, Ce, Ce, Gll^Fmw, Gll^Fmw, Gll^Fmw, Hhd^Fmw, Mm, Mm, Mm, Mm, Mm, Mm, Mm, Mm
Mm, Mm, Mm, Mm, Mm, Hhd, Hhd, Cud, Cud, 4 Kud, Cud, Cud, Gd, Gd^Es, Gd^Es, Hhd, Hhd, Mm, Mm, Mm, Mm, Mm, Mm, Mm, Mm, Mm, Hhd^Fmw, Hhd^Fmw, Gll^Fmw, Gll^Fmw, Gll, Gll, Gll, Gll, Gll^Fmw, Gll^Fmw, Gll^Fmw, Hhd^Fmw, Mm, Mm, Mm, Mm, Mm, Mm, Mm, Mm
Mm, Mm^Xm, Mm, Mm, Mm, Uu^Vud, Hhd, Hhd, Cud, Cud, Cud, Cud, Gd, Gd, Gd^Es, Hhd^Fmw, Hhd^Fmw, Mm, Mm, Mm, Mm, Mm, Mm, Mm, Hhd^Fmw, Hhd^Fmw, Hhd^Fmw, Hhd^Fmw, Gll^Fmw, Re^Vct, Gll, Gll^Es, Gll^Es, Re^Vct, Gll^Fmw, Gll^Fmw, Gll^Fmw, Hhd^Fmw, Hhd^Fmw, Mm, Mm, Mm, Mm, Mm, Mm, Mm
Mm, Mm^Xm, Mm, Mm, Mm, Mm, Hhd^Fmw, Hhd^Fmw, Gd, Cud, Gd, Gd, Gd, Gd, Gd, Hhd^Fmw, Hhd^Fmw, Mm, Mm, Mm, Hhd^Fmw, Mm, Mm, Mm, Hhd^Fmw, Hhd^Fmw, Gll^Fmw, Gll^Fmw, Gll^Fmw, Gll, Gll, Gll, Gll, Gll, Gll^Fmw, Gll^Fmw, Gll^Fmw, Gll^Fmw, Hhd^Fmw, Mm, Mm, Mm, Mm, Mm, Mm, Mm
Mm, Mm^Xm, Mm, Mm, Mm, Hhd^Fmw, Hhd^Fmw, Hhd^Fmw, Hhd^Fmw, Gd, Gd, Gd, Gd^Es, Gd, Gd, Hhd^Fmw, Cud, Mm, Mm, Mm, Hhd^Fmw, Hhd^Fmw, Hhd^Fmw, Hhd^Fmw, Gll^Fmw, Gll^Fmw, Gll^Fmw, Gll^Fmw, Gll, Gll, Gll, Gll, Gll, Gll, Gll^Fmw, Gll^Fmw, Gd^Fetd, Gll^Fmw, Hhd^Fmw, Mm, Mm, Mm, Hhd^Fmw, Mm, Mm, Mm
Mm, Mm, Mm^Xm, Mm, Mm, Mm, Hhd^Fmw, Hhd^Fmw, Hhd^Fmw, Gll^Fmw, Gll^Fmw, Gd, Gd, Gd, Gll^Fmw, Cud, Cud, Cud, Hhd^Fmw, Hhd^Fmw, Gll^Fmw, Hhd^Fmw, Gll^Fmw, Gll^Fmw, Gll^Fmw, Gll^Fmw, Gll^Fmw, Gll^Fmw, Gll^Fmw, Gll, Gll, Gll, Gll, Gll, Gll^Fmw, Gll^Fmw, Gll^Fmw, Gll^Fmw, Hhd^Fmw, Mm, Mm, Mm, Ww, Ww, Ww, Ww
Mm, Mm, Mm^Xm, Mm, Mm, Mm, Mm, Mm, Mm, Hhd^Fmw, Cud, Cud, Gd, Gd, Gll^Fmw, Gll^Fmw, Gll^Fmw, Hhd^Fmw, Gll^Fmw, Gll^Fmw, Gll^Fmw, Gll^Fmw, Gll^Fmw, Gll^Fmw, Gll^Fmw, Gd^Fetd, Gll^Fmw, Gll^Fmw, Gll, Gll^Es, Gll, Gll, Gll, Gll, Gll^Fmw, Gll^Fmw, Gll^Fmw, Gll^Fmw, Gll^Fmw, Hhd^Fmw, Ww, Ww, Ww, Ww, Ww, Ww
Mm, Mm^Xm, Mm, Mm, Mm, Mm, Mm, Mm, Mm, Mm, Cud, Cud, Gll, Gll, Gll, Gll^Fmw, Gll, Gll^Fmw, Gll^Fmw, Gll^Fmw, Gll^Fmw, Gll^Fmw, Gll, Gll^Fmw, Gll^Fmw, Gll^Fmw, Gll^Fmw, Gll, Gll, Gll, Gll, Gll, Ww, Ww, Ww, Gll^Fmw, Gll^Fmw, Gll^Fmw, Ww, Ww, Ww, Ww, Mm, Mm, Mm, Ww
Mm^Xm, Mm^Xm, Mm, Mm, Mm, Mm, Mm, Mm, Mm, Mm, Hhd^Fmw, Gll^Fmw, Gll, Gll, Gll, Gll, Gll, Gll, Gll, Gll, Gll, Gll, Gll, Gll, Gll, Gg^Ve, Gll, Gll, Gll, Gll, Ww, Ww, Ww, Ww, Ww, Ww, Ww, Ww, Ww, Ww, Mm, Mm, Mm, Mm, Mm, Mm
Mm^Xm, Mm, Mm, Mm, Mm, Mm, Hhd^Fmw, Mm, Hhd^Fmw, Hhd^Fmw, Gll^Fmw, Gll^Fmw, Gll, Gll, Gll, Gll, Gll, Gll, Gll, Gll, Gll, Gll, Gll, Gll, Gll, Gll, Gll, Gll, Gll, Ww, Ww, Ww, Gll, Gll, Gll, Ww, Ww, Ww, Hhd^Fmw, Hhd^Fmw, Mm, Mm, Mm, Mm, Mm, Mm
Mm, Mm, Mm, Mm, Hhd^Fmw, Hhd^Fmw, Hhd^Fmw, Hhd^Fmw, Hhd^Fmw, Gll^Fmw, Gll^Fmw, Gll^Fmw, Gll, Gll, Gll, Gll^Es, Gll, Gll, Ww, Ww, Ww, Gll, Ww, Gll, Gll, Gll^Es, Gll, Gll, Ww, Ww, Gll, Gll, Gll^Fmw, Gll^Fmw, Gll^Fmw, Gll, Gll^Fmw, Gll^Fmw, Hhd^Fmw, Hhd^Fmw, Mm, Mm, Mm, Mm, Mm, Mm
Mm, Mm, Mm, Mm, Hhd^Fmw, Hhd^Fmw, Gll^Fmw, Gll^Fmw, Gll^Fmw, Gll^Fmw, Gll^Fmw, Gll^Fmw, Gll^Fmw, Gll, Gll, Gll, Ww, Ww, Ww, Ww^Ewf, Ww^Ewf, Ww, Ww, Ww, Ww, Gll, Gll, Gll, Ww, Ww, Gll, Gll^Es, Gll^Fmw, Gll^Fmw, Gll^Fmw, Gd^Fetd, Gll^Fmw, Gll^Fmw, Hhd^Fmw, Hhd^Fmw, Mm, Mm, Mm, Mm, Mm, Mm
Mm, Mm, Mm, Mm, Hhd^Fmw, Gll^Fmw, Gll^Fmw, Gll^Fmw, Gll^Fmw, Gll^Fmw, Gd^Fetd, Gll^Fmw, Gll^Fmw, Gll, Ww, Ww^Bw\, Ww^Bw\, Ww, Gg^Fet, Ww, Gg^Fet, Ww^Ewf, Ww^Ewf, Ww, Ww^Ewf, Ww, Ww, Wwf, Ww, Gll, Gll, Gll^Fmw, Gll^Fmw, Gll^Fmw, Gll^Fmw, Gll^Fmw, Gll^Fmw, Hhd^Fmw, Hhd^Fmw, Hhd^Fmw, Mm, Mm, Mm, Mm, Mm, Mm
Mm, Mm, Mm, Mm, Hhd^Fmw, Gll^Fmw, Gd^Fetd, Gll^Fmw, Gll^Fmw, Gll^Fmw, Gll^Fmw, Gll^Fmw, Gll^Fmw, Gll, Ww, Ww, Gg^Fet, Gg^Fet, Gg^Fet, Gg^Fet, Cv, Gg^Fet, Gg^Fet, Ww^Ewf, Ww, Ww, Ww, Wwf, Gll, Gll, Gll, Gll^Fmw, Gll^Fmw, Gd^Fetd, Gll^Fmw, Gll^Fmw, Hhd^Fmw, Hhd^Fmw, Mm, Mm, Mm, Mm, Mm, Mm, Mm, Mm
Mm, Mm, Hhd^Fmw, Hhd^Fmw, Gll^Fmw, Gll^Fmw, Gll^Fmw, Gll^Fmw, Ww, Gll^Fmw, Ww, Gll^Fmw, Gll, Gll^Es, Ww, Ww^Ewf, Ww^Ewf, Gg^Ve, Gg^Fet, Cv, 2 Kv, Cv, Gg^Fet, Ww^Ewf, Ww^Ewf, Ww, Ww^Ewf, Ww, Gll^Es, Gll, Gll^Fmw, Gll^Fmw, Gg^Ve, Gll^Fmw, Gll^Fmw, Gll^Fmw, Hhd^Fmw, Hhd^Fmw, Mm, Mm, Mm, Mm, Mm, Mm, Mm, Mm
Hhd^Fmw, Hhd^Fmw, Hhd^Fmw, Hhd^Fmw, Gll^Fmw, Gll^Fmw, Ww, Ww, Ww, Ww, Ww, Ww, Wwf, Gg^Ve, Ww, Ww^Ewf, Ww^Ewf, Gg^Fet, Gg^Fet, Cv, Cv, Cv, Gg^Fet, Gg^Ve, Ww^Ewf, Ww^Ewf, Ww^Ewf, Ww, Gll, Gll, Gll^Fmw, Gll^Fmw, Gll^Fmw, Gll^Fmw, Hhd^Fmw, Hhd^Fmw, Mm, Mm, Mm, Mm, Mm, Mm, Mm, Mm^Xm, Mm, Mm
Hhd^Fmw, Hhd^Fmw, Gll^Fmw, Gll^Fmw, Gll^Fmw, Gll^Fmw, Ww, Ww, Gll^Fmw, Ww, Gll^Fmw, Ww, Wwf, Wwf, Ww, Ww, Ww, Gg^Ve, Gg^Fet, Gg^Fet, Gg^Ve, Gg^Fet, Gg^Fet, Gg^Fet, Ww, Ww, Ww, Ww, Gll^Es, Gll, Gll^Fmw, Gll^Fmw, Gll^Fmw, Gll^Fmw, Hhd^Fmw, Hhd^Fmw, Mm, Mm, Mm, Mm, Mm, Mm, Mm, Mm^Xm, Mm, Mm
Gll^Fmw, Gll^Fmw, Gll^Fmw, Gll^Fmw, Ww, Ww, Ww, Ww, Gll^Fmw, Gll^Fmw, Gll^Fmw, Gll, Gll, Ww, Ww, Ww, Ww, Wwf, Wwf, Wwf, Ww, Ww^Ewf, Ww^Ewf, Ww^Ewf, Ww, Ww^Ewf, Ww, Ww, Gll, Gll, Gll, Gll^Fmw, Gll^Fmw, Hhd^Fmw, Hhd^Fmw, Mm, Mm, Mm, Mm, Mm, Mm, Mm, Mm, Mm^Xm, Mm, Mm
Gll^Fmw, Gll^Fmw, Gll^Fmw, Gg^Ve, Ww, Ww, Gll^Fmw, Gll^Fmw, Hhd^Fmw, Hhd^Fmw, Hhd^Fmw, Gll, Gll, Gll^Es, Gll, Ww, Ww, Ww, Ww, Ww, Ww, Ww, Ww, Ww, Ww, Ww, Ww, Ww, Gll, Gll^Es, Gll, Gll^Fmw, Gll^Fmw, Hhd^Fmw, Hhd^Fmw, Mm, Mm, Mm, Mm, Mm, Mm, Mm, Mm^Xm, Mm^Xm, Mm, Mm
Ww, Ww, Ww, Ww, Ww, Ww, Gll^Fmw, Gll^Fmw, Hhd^Fmw, Hhd^Fmw, Hhd^Fmw, Gll^Fmw, Gll^Fmw, Gll^Fmw, Gll^Fmw, Gll, Gll^Es, Ww, Ww, Ww, Gll, Gll, Gll, Gg^Ve, Gll, Ww, Ww, Ww, Gll^Es, Gll, Gll, Gll^Fmw, Hhd^Fmw, Hhd^Fmw, Mm, Mm, Mm, Mm, Mm, Mm, Mm, Mm, Mm, Mm, Mm, Mm
Ww, Ww, Gll^Fmw, Ww, Gll^Fmw, Gll^Fmw, Hhd^Fmw, Hhd^Fmw, Mm, Hhd^Fmw, Mm, Hhd^Fmw, Hhd^Fmw, Hhd^Fmw, Hhd^Fmw, Gll^Fmw, Gll^Fmw, Gll, Gll, Gll, Gll, Gll^Es, Gll, Gll^Es, Gll, Ww, Ww, Ww, Gll^Es, Gll, Gll, Gll^Fmw, Hhd^Fmw, Hhd^Fmw, Mm, Mm, Mm, Mm^Xm, Mm, Mm, Mm, Mm, Mm^Xm, Mm, Mm, Mm
Gll^Fmw, Gll^Fmw, Gll^Fmw, Gll^Fmw, Gll^Fmw, Hhd^Fmw, Mm, Mm, Mm, Mm, Mm, Mm, Mm, Hhd^Fmw, Hhd^Fmw, Hhd^Fmw, Hhd^Fmw, Gll^Fmw, Gll^Fmw, Gll, Gll^Fmw, Gll, Gll, Gll, Gll, Ww, Ww, Ww, Gll, Gll, Gll^Fmw, Gll^Fmw, Hhd^Fmw, Mm, Mm, Mm, Mm, Mm, Mm, Mm, Mm, Mm, Mm, Mm, Mm, Mm
Gll^Fmw, Gll^Fmw, Gd^Fetd, Gll^Fmw, Hhd^Fmw, Hhd^Fmw, Mm, Mm, Mm, Mm, Mm, Mm, Mm, Mm, Mm, Hhd^Fmw, Hhd^Fmw, Gll^Fmw, Hhd^Fmw, Gll^Fmw, Hhd^Fmw, Gll^Fmw, Gll, Gll^Es, Gll, Ww, Ww, Ww, Gll, Gll, Gll^Fmw, Gll^Fmw, Hhd^Fmw, Mm, Mm, Mm, Mm, Mm, Mm, Mm, Mm, Mm, Mm, Mm, Mm, Mm
Gll^Fmw, Gll^Fmw, Gll^Fmw, Gll^Fmw, Hhd^Fmw, Mm, Mm, Mm, Mm, Mm, Mm, Mm, Mm, Mm, Mm, Mm, Mm, Hhd^Fmw, Mm, Hhd^Fmw, Hhd^Fmw, Gll^Fmw, Gll^Fmw, Gll, Gll, Gll, Ww, Ww, Gll, Gll, Gll^Fmw, Gll^Fmw, Hhd^Fmw, Mm, Mm, Mm, Mm, Mm, Mm, Mm, Mm, Mm, Mm, Mm, Mm, Mm
Gll^Fmw, Gll^Fmw, Gll^Fmw, Gll^Fmw, Hhd^Fmw, Mm, Mm, Mm, Mm, Mm, Mm, Mm^Xm, Mm, Mm, Mm, Mm, Mm, Mm, Mm^Xm, Mm, Mm, Hhd^Fmw, Hhd^Fmw, Gll^Fmw, Gll^Fmw, Gll, Ww, Ww, Gll, Gll, Gll^Fmw, Hhd^Fmw, Hhd^Fmw, Mm, Hhd^Fmw, Mm, Hhd^Fmw, Hhd^Fmw, Hhd^Fmw, Mm, Hhd^Fmw, Mm, Mm, Mm, Mm, Hhd^Fmw
Hhd^Fmw, Gll^Fmw, Gll^Fmw, Gll^Fmw, Hhd^Fmw, Mm, Mm, Mm, Mm, Mm, Mm^Xm, Mm^Xm, Mm, Mm^Xm, Mm^Xm, Mm, Mm, Mm^Xm, Mm^Xm, Mm^Xm, Mm^Xm, Mm, Mm, Hhd^Fmw, Gll^Fmw, Gll, Gll, Wwf, Ww, Gll, Gll^Fmw, Hhd^Fmw, Hhd^Fmw, Hhd^Fmw, Hhd^Fmw, Hhd^Fmw, Hhd^Fmw, Hhd^Fmw, Hhd^Fmw, Hhd^Fmw, Hhd^Fmw, Hhd^Fmw, Hhd^Fmw, Mm, Hhd^Fmw, Hhd^Fmw
Mm, Hhd^Fmw, Hhd^Fmw, Hhd^Fmw, Mm, Mm, Mm, Mm, Mm, Mm, Mm, Mm, Mm, Mm, Mm, Mm, Mm, Mm, Mm, Mm, Mm, Mm^Xm, Mm, Hhd^Fmw, Gll^Fmw, Gll, Gll, Ww, Wwf, Gll, Gll, Gll^Fmw, Gll^Fmw, Gll^Fmw, Gll^Fmw, Hhd^Fmw, Gll^Fmw, Hhd^Fmw, Gll^Fmw, Hhd^Fmw, Hhd^Fmw, Hhd^Fmw, Hhd^Fmw, Hhd^Fmw, Gll^Fmw, Gll^Fmw
Mm, Mm, Mm, Hhd^Fmw, Mm, Mm, Mm, Mm^Xm, Mm^Xm, Mm^Xm, Mm^Xm, Mm, Mm, Mm, Mm, Mm, Mm, Mm, Mm, Mm, Mm, Mm, Mm, Hhd^Fmw, Gll^Fmw, Gll, Gll, Gll, Ww, Ww, Ww, Gll, Gll, Gll, Gll, Gll^Fmw, Gll, Gll^Fmw, Gg^Ve, Gll^Fmw, Gll^Fmw, Gll^Fmw, Gll^Fmw, Gll^Fmw, Gll^Fmw, Gll^Fmw
Mm, Mm, Mm, Mm, Mm, Mm, Mm, Mm, Mm, Mm, Mm^Xm, Mm^Xm, Mm, Mm, Hhd^Fmw, Hhd^Fmw, Hhd^Fmw, Hhd^Fmw, Hhd^Fmw, Hhd^Fmw, Hhd^Fmw, Hhd^Fmw, Hhd^Fmw, Gll^Fmw, Gll^Fmw, Gll, Gll^Es, Gll, Gll, Ww, Ww, Ww, Ww, Wwf, Ww, Gll, Gll, Gll, Gll, Gll^Fmw, Gll^Fmw, Gll^Fmw, Gll, Gll, Gll^Fmw, Gll^Fmw
Mm, Mm, Mm, Mm, Mm, Mm, Mm, Mm, Mm, Mm, Mm^Xm, Mm, Mm, Mm, Hhd^Fmw, Hhd^Fmw, Gll^Fmw, Gll^Fmw, Gll^Fmw, Gll^Fmw, Gll^Fmw, Gll^Fmw, Gll^Fmw, Gll^Fmw, Gll, Gll, Gll, Gll, Gll, Gll, Gll^Fmw, Ww, Ww, Wwf, Ww, Ww, Wwf, Ww, Ww, Gll, Gll, Gll, Ww, Gll, Gll, Gll
Mm, Mm, Mm, Mm, Mm, Mm, Mm, Mm, Mm, Mm, Mm, Mm, Mm, Mm, Hhd^Fmw, Gll^Fmw, Gll^Fmw, Gll, Gll, Gll, Gll, Gd^Fetd, Gll, Gll, Gll, Gll, Gll, Gll, Gll^Fmw, Gll^Fmw, Gll^Fmw, Gll^Fmw, Gll, Gll, Gll, Ww, Gll, Ww, Ww, Ww, Ww, Ww, Ww, Ww, Ww, Ww
Mm, Mm, Mm, Mm, Mm, Mm, Hhd^Fmw, Mm, Mm, Mm, Mm, Mm, Mm, Mm, Mm, Hhd^Fmw, Hhd^Fmw, Gll^Fmw, Gll^Fmw, Gll, Gll, Gll, Gll, Gll, Gll, Gll^Es, Gll^Fmw, Gll^Fmw, Gg^Ve, Gd^Fetd, Gll^Fmw, Gll^Fmw, Gll, Gll, Gll, Gll, Gll, Gll, Gll, Ww, Ww, Ww, Gll, Ww, Ww, Ww
Hhd^Fmw, Mm, Mm, Mm, Mm, Hhd^Fmw, Hhd^Fmw, Hhd^Fmw, Mm, Mm, Mm, Mm, Mm, Mm, Mm, Hhd^Fmw, Hhd^Fmw, Gll^Fmw, Gll^Fmw, Gll^Es, Gll, Gll, Gll^Fmw, Gll, Gll, Gll, Gll, Gll^Fmw, Gll^Fmw, Gll^Fmw, Gll^Fmw, Gll^Fmw, Gll, Gll, Gll, Gll^Es, Gll, Gll, Gll^Es, Gll, Gll, Gll, Gll^Fmw, Gll, Gll, Gll
Hhd^Fmw, Hhd^Fmw, Hhd^Fmw, Mm, Hhd^Fmw, Hhd^Fmw, Hhd^Fmw, Hhd^Fmw, Hhd^Fmw, Mm, Mm, Mm, Mm, Mm, Hhd^Fmw, Hhd^Fmw, Hhd^Fmw, Gd^Fetd, Gll^Fmw, Gll, Gll^Fmw, Gll^Fmw, Gll^Fmw, Gll^Fmw, Gll, Gll, Gll, Gll^Fmw, Hhd^Fmw, Hhd^Fmw, Hhd^Fmw, Hhd^Fmw, Hhd, Gll, Gll, Gll, Hhd, Gll, Gll, Gll, Gll, Gll^Fmw, Gg^Ve, Gll^Fmw, Gll^Fmw, Gll
Gll^Fmw, Hhd^Fmw, Hhd^Fmw, Hhd^Fmw, Hhd^Fmw, Hhd^Fmw, Gll^Fmw, Hhd^Fmw, Hhd^Fmw, Hhd^Fmw, Hhd^Fmw, Hhd^Fmw, Hhd^Fmw, Hhd^Fmw, Hhd^Fmw, Hhd^Fmw, Gll^Fmw, Gll^Fmw, Gll, Gll, Gll^Fmw, Gg^Ve, Gll^Fmw, Gll, Gll, Gll, Hhd, Hhd^Fmw, Hhd^Fmw, Mm, Mm, Mm, Mm, Hhd, Hhd, Hhd, Mm, Hhd, Hhd, Gll, Gll, Gll^Fmw, Gll^Fmw, Gll^Fmw, Gll^Fmw, Gll^Fmw
Gll^Fmw, Gll^Fmw, Gll^Fmw, Gll^Fmw, Gll^Fmw, Gll^Fmw, Gll^Fmw, Gll^Fmw, Gll^Fmw, Hhd^Fmw, Hhd^Fmw, Hhd^Fmw, Gll^Fmw, Hhd^Fmw, Hhd^Fmw, Hhd^Fmw, Gll^Fmw, Gll^Fmw, Gll, Gll, Gll^Fmw, Gll^Fmw, Gll, Gll, Hhd, Hhd, Mm, Hhd^Fmw, Mm, Mm, Mm, Mm, Mm, Mm, Mm, Mm, Mm, Mm, Hhd, Gll, Gll, Gll, Gll^Fmw, Gll^Fmw, Gll^Fmw, Gll^Fmw
Gll, Gll^Fmw, Gll^Fmw, Gll^Fmw, Gll^Fmw, Gll^Fmw, Gll, Gll, Gll^Fmw, Gll^Fmw, Gll^Fmw, Gll^Fmw, Gll^Fmw, Gll^Fmw, Gll^Fmw, Gll^Fmw, Gll, Gll, Gll, Gll^Fmw, Gll^Fmw, Gll, Gll, Gll, Hhd, Mm, Mm, Mm, Mm, Mm, Mm, Mm, Mm, Mm, Mm, Mm, Mm, Mm, Hhd^Fmw, Gll, Gll, Gll, Gll, Gll^Fmw, Gll^Fmw, Gll^Fmw
Gll, Gll, Gll, Gll, Gll, Gd^Fetd, Gll, Gll, Gll, Gll^Fmw, Gll, Gll^Fmw, Gll, Gll^Fmw, Gll, Gll, Gll, Gll, Gll^Fmw, Gll^Fmw, Gll^Fmw, Gll^Fmw, Gll, Gll^Es, Hhd^Fmw, Mm, Mm, Mm, Mm, Mm, Mm, Mm, Mm, Mm, Mm, Mm, Mm, Hhd^Fmw, Gll, Gll, Gll, Gll, Gll, Gll^Fmw, Gll^Fmw, Gll^Fmw
Gll, Gll, Gll, Gll, Gll, Gll, Gll, Gll, Gll^Es, Gll, Gll^Es, Gll, Gll, Gll, Gll, Gll, Gll, Gll^Fmw, Gll^Fmw, Gll^Fmw, Gll^Fmw, Gll, Gll, Gll, Hhd^Fmw, Hhd^Fmw, Mm, Mm, Mm, Mm, Mm, Mm, Mm, Mm, Mm, Mm, Hhd^Fmw, Hhd^Fmw, Hhd, Gll, Gll, Gll^Es, Gll, Gll^Fmw, Gll^Fmw, Gll^Fmw
Gll, Gll, Gll, Gll, Gll, Gll, Gll, Gll, Gll, Gll, Gll^Es, Gll, Gll, Gll^Es, Gll, Gll, Gll^Fmw, Gll^Fmw, Gll^Fmw, Gg^Ve, Gll^Fmw, Gll, Gll, Gll, Hhd^Fmw, Hhd^Fmw, Mm, Mm, Mm, Mm, Mm, Mm, Mm, Mm, Mm, Mm, Mm, Mm, Mm, Hhd, Gll, Gll, Gll, Gll^Fmw, Gll^Fmw, Gll^Fmw
Gll, Gll, Gll, Gll^Es, Gll, Gll, Gll^Fmw, Gll, Gll^Fmw, Gll, Gll, Gll, Gll, Gll, Gll, Gll, Gll, Gll^Fmw, Gll^Fmw, Gll^Fmw, Gll^Fmw, Gll, Gll, Hhd, Hhd^Fmw, Mm, Mm, Mm, Mm, Mm, Mm, Mm, Mm, Mm, Mm, Mm, Mm, Mm, Hhd, Hhd, Gll, Gll, Gll, Gll, Gll^Fmw, Gll^Fmw
Gll^Fmw, Gll, Gll^Fmw, Gll^Fmw, Gll^Fmw, Gll^Fmw, Gll^Fmw, Gll^Fmw, Gll^Fmw, Gll^Fmw, Gll^Fmw, Gll^Fmw, Gll^Fmw, Gll, Gll, Gll, Gll, Gll^Fmw, Gll^Fmw, Gll^Fmw, Gll^Fmw, Gll, Gll, Hhd, Mm, Mm, Mm, Mm, Mm, Mm, Mm, Mm, Mm, Mm, Hhd^Fmw, Mm, Mm, Mm, Hhd, Gll, Gll^Es, Gll, Gll^Fmw, Gll^Fmw, Gll^Fmw, Gll^Fmw
Gll^Fmw, Gll^Fmw, Gll^Fmw, Gll^Fmw, Gll^Fmw, Gll^Fmw, Gll^Fmw, Gll^Fmw, Gg^Ve, Gll^Fmw, Gll^Fmw, Gll^Fmw, Gll^Fmw, Gll, Gll, Re^Vct, Gll, Gll, Gll, Re^Vct, Gll, Gll^Es, Gll, Hhd, Mm, Mm, Mm, Mm, Mm, Mm, Hhd, Hhd, Hhd, Hhd^Fmw, Gll, Hhd^Fmw, Hhd, Hhd, Gll, Gll, Gll^Es, Gll, Gll^Fmw, Gll^Fmw, Gll^Fmw, Gll^Fmw
Gll^Fmw, Gll^Fmw, Gll^Fmw, Gll^Fmw, Gll^Fmw, Gll^Fmw, Gll^Fmw, Gll^Fmw, Gll^Fmw, Gll^Fmw, Gll^Fmw, Gll^Fmw, Gll, Gll, Gll, Gll, Ce, Gll, Gll, Gll, Gll, Gll, Gll, Hhd, Hhd, Mm, Hhd^Fmw, Hhd^Fmw, Hhd^Fmw, Hhd, Gll, Hhd, Gll, Gll, Gll, Gll, Gll, Gll, Gll, Gll, Gll, Gll, Gll^Fmw, Gll^Fmw, Gll^Fmw, Gll^Fmw
Gll^Fmw, Gll^Fmw, Gll^Fmw, Gll^Fmw, Gll^Fmw, Gll^Fmw, Gll^Fmw, Gll^Fmw, Gll^Fmw, Gll^Fmw, Gll^Fmw, Gll^Fmw, Gll, Gll, Ce, Ce, Ce, Ce, Ce, Gll, Gll, Re^Vct, Gll, Gll, Gll, Hhd, Gll^Fmw, Gll^Fmw, Gll^Fmw, Gll, Gll, Gll, Gll, Gll, Gll, Gll, Gll^Es, Gll, Gll, Gll, Gll, Gll^Fmw, Gll^Fmw, Gll^Fmw, Gll^Fmw, Gll^Fmw
Gll^Fmw, Gll^Fmw, Gll^Fmw, Gll^Fmw, Gg^Ve, Gll^Fmw, Gll^Fmw, Gll^Fmw, Gll^Fmw, Gll^Fmw, Gll^Fmw, Gll^Fmw, Gll, Gll, Ce, Ce, 3 Ke, Ce, Ce, Gll, Gll, Gll, Gll, Gll, Gll, Gll, Gll^Fmw, Gll^Fmw, Gg^Ve, Gll^Fmw, Gll, Gll, Gll^Es, Gll, Gll, Gll, Gll, Gll, Gll^Fmw, Gll, Gll^Fmw, Gll^Fmw, Gll^Fmw, Gll^Fmw, Gll^Fmw, Gll^Fmw
Gll^Fmw, Gll^Fmw, Gll^Fmw, Gll^Fmw, Gll^Fmw, Gll^Fmw, Gll^Fmw, Gll^Fmw, Gll^Fmw, Gll^Fmw, Gll, Gll, Re^Vct, Gll, Gll, Ce, Ce, Ce, Gll, Gll, Gll, Gll, Gll, Gll, Gll, Gll, Gll, Gll^Fmw, Gll^Fmw, Gll^Fmw, Gll, Gll, Gll, Gll, Gll, Gll, Gll^Fmw, Gll^Fmw, Gll^Fmw, Gll^Fmw, Gll^Fmw, Gll^Fmw, Gg^Ve, Gll^Fmw, Gll^Fmw, Gll^Fmw
Gll^Fmw, Gll^Fmw, Gll^Fmw, Gll^Fmw, Gll^Fmw, Gll^Fmw, Gll^Fmw, Gll^Fmw, Gll, Gll, Gll, Gll, Gll, Gll, Gll, Gll, Gll, Gll, Gll, Gll, Re^Vct, Gll, Gll, Gll, Gll, Gll, Gll, Gll, Gll, Gll, Gll, Gll, Gll, Gll, Gll^Fmw, Gll^Fmw, Gll^Fmw, Gll^Fmw, Gll^Fmw, Gll^Fmw, Gll^Fmw, Gll^Fmw, Gll^Fmw, Gll^Fmw, Gll^Fmw, Gll^Fmw
Gll^Fmw, Gll^Fmw, Gll^Fmw, Gll^Fmw, Gll^Fmw, Gll^Fmw, Gll, Gll, Gll, Gll, Gll, Gll, Gll, Gll, Gll, Gll, Gll, Gll, Gll, Gll, Gll, Gll^Es, Gll, Gll, Gll, Gll, Gll, Gll, Gll, Gll, Gll, Gll, Gll, Gll^Fmw, Gll^Fmw, Gll^Fmw, Gll^Fmw, Gll^Fmw, Gll^Fmw, Gll^Fmw, Gll^Fmw, Gll^Fmw, Gll^Fmw, Gll^Fmw, Gll^Fmw, Gll^Fmw
Gll^Fmw, Gll^Fmw, Gll^Fmw, Gll^Fmw, Gll^Fmw, Gll^Fmw, Gll, Gll, Gll, Gll, Gll, Gll, Gll, Gll, Gll, Gll, Gll, Gll, Gll, Gll, Gll, Gll, Gll, Gll, Gll, Gll, Gll, Gll, Gll, Gll, Gll, Gll, Gll, Gll^Fmw, Gll^Fmw, Gll^Fmw, Gll^Fmw, Gll^Fmw, Gll^Fmw, Gll^Fmw, Gll^Fmw, Gll^Fmw, Gll^Fmw, Gll^Fmw, Gll^Fmw, Gll^Fmw
